NO ./sources/textures/sandbrick_wall.xpm
SO ./sources/textures/bat_brick.xpm
WE ./sources/textures/stonewallcreepy.xpm
EA ./sources/textures/brickwallcracked.xpm

F 220,100,10 
C 225,30,0

111111111111111111111
100000000000000000000
1000000000N00000000011111
1000000000000000000000001
1111111111111111111111111