NO ./sources/textures/sandbrick_wall.xpm
SO ./sources/textures/bat_brick.xpm
WE ./sources/textures/stonewallcreepy.xpm
EA ./sources/textures/brickwallcracked.xpm

F 220,100,10 
C 225,30,0

111111111111111111111111
100000000000000000000001
100000000000000000000001
100000000000000000000001
100000111110000101010001
100000100010000000000001
100000100010000100010001
100000100010000000000001
100000101110000101010001
100000000000000000000001
10000000000S000000000001
100000000000000000000001
100000000000000000000001
100000000000000000000001
100000000000000000000001
100000000000000000000001
111111111000000000000001
110100001000000000000001
110000501000000000000001
110100001000000000000001
110111111000000000000001
110000000000000000000001
111111111000000000000001
111111111111111111111111