NO ./sources/textures/path_to_the_north_texture
SO ./sources/textures/path_to_the_south_texture
WE ./sources/textures/path_to_the_west_texture
EA ./sources/textures/path_to_the_east_texture

F 220,100,3
C 225,30,0

111111111111111111111
100000000000N00000001
100000000000000000001
111111111111111111111