NO ./sources/textures/sandbrick_wall.xpm
SO ./sources/textures/bat_brick.xpm
WE ./sources/textures/stonewallcreepy.xpm
EA ./sources/textures/brickwallcracked.xpm

F 220,100,10 
C 225,30,0

111111111111111111111111
100000000000000000000001
100010101010000000000001
100E00000000000000000001
110000101010000101010001
101100000000000000000001
111111111111111111111111