NO ./sources/textures/brick_candle.xpm
SO ./sources/textures/bat_brick.xpm
WE ./sources/textures/stonewallcreepy.xpm
EA ./sources/textures/brickwallcracked.xpm

F 166,166,166
C 62,62,62

111111111111111111111111
101000000000000000000001
110000101010000000000001
1000000E0000000000000001
100000001010000101010001
101100000000000000000001
111111111111111111111111